                            
                            
                            
++++++++++++++++++++++++++++
+............++............+
+.++++.+++++.++.+++++.++++.+
+*+  +.+   +.++.+   +.+  +*+
+.++++.+++++.++.+++++.++++.+
+..........................+
+.++++.++.++++++++.++.++++.+
+.++++.++.++++++++.++.++++.+
+......++....++....++......+
++++++.+++++ ++ +++++.++++++
     +.+++++ ++ +++++.+     
     +.++          ++.+     
     +.++ +++--+++ ++.+     
++++++.++ +      + ++.++++++
      .   +      +   .      
++++++.++ +      + ++.++++++
     +.++ +++..+++ ++.+     
     +.++          ++.+     
     +.++ ++++++++ ++.+     
++++++.++ ++++++++ ++.++++++
+............++............+
+.++++.+++++.++.+++++.++++.+
+.++++.+++++.++.+++++.++++.+
+*..++.......  .......++..*+
+++.++.++.++++++++.++.++.+++
+++.++.++.++++++++.++.++.+++
+......++....++....++......+
+.++++++++++.++.++++++++++.+
+.++++++++++.++.++++++++++.+
+..........................+
++++++++++++++++++++++++++++
                            
                            
